#######################################
#                                     #
# ######### ## ######### ## ######### #
#         #        #        #         #
# # ##### #### ### # ### #### ##### # #
# #              # & #              # #
# ######### #### # # # #### ######### #    
#         #        #        #         #
# ####### ##### ## # ## ##### ####### #
# #           #         #           # #
# # ######### ##### ##### ######### # #
#                                     #
#######################################
%                                     #